#####################
#   # #     # # #   #
# # # ##### # # # ###
# # #     #         #
# # # # ### ### # ###
# # # #     #   #   #
### ######### # # # #
#       #     # # # #
####### ####### # # #
# #   # # #     # # #
# # ### # # ### #####
#           #       #
# # ### ### ### #####
# #   # #   #       #
# # ### ### # # ### #
# #   # #   # # #   #
####### # ### # # ###
#       # #   # #   #
# ### # ####### ### #
#   # #     #     # #
#####################