###############
#         # # #
####### # # # #
#   # # # #   #
### # # ##### #
#             #
####### # # # #
# # #   # # # #
# # # ### # # #
#     # # # # #
##### # # ### #
#     #     # #
# ### ### ### #
# #     #   # #
###############